,num_images,num_males,num_females,cooccuring,min_num_gender
person,33912,24086,9826,"[('chair', 4157), ('car', 3357), ('tennis racket', 2926), ('handbag', 2896), ('skateboard', 2754), ('sports ball', 2653), ('cell phone', 2552), ('surfboard', 2457), ('dining table', 2431), ('bottle', 2395), ('backpack', 2381), ('cup', 2303), ('tie', 2199), ('bench', 2114), ('skis', 1622), ('umbrella', 1547), ('truck', 1355), ('bowl', 1341), ('bicycle', 1312), ('motorcycle', 1283), ('baseball glove', 1270), ('baseball bat', 1245), ('book', 1228), ('couch', 1153), ('dog', 1146), ('frisbee', 1142), ('knife', 1079), ('remote', 1059), ('horse', 1055), ('snowboard', 1042), ('laptop', 1024), ('tv', 980), ('potted plant', 975), ('kite', 919), ('wine glass', 797), ('spoon', 747), ('clock', 739), ('suitcase', 731), ('pizza', 720), ('traffic light', 710), ('bed', 708), ('cake', 685), ('bus', 671), ('fork', 663), ('oven', 660), ('boat', 653), ('sink', 614), ('refrigerator', 529), ('banana', 490), ('vase', 423), ('donut', 410), ('sandwich', 409), ('elephant', 392), ('train', 364), ('hot dog', 355), ('teddy bear', 349), ('cat', 339), ('keyboard', 322), ('microwave', 316), ('bird', 314), ('cow', 299), ('toothbrush', 299), ('fire hydrant', 262), ('mouse', 243), ('scissors', 236), ('stop sign', 234), ('toilet', 226), ('apple', 219), ('orange', 214), ('giraffe', 181), ('airplane', 180), ('sheep', 180), ('carrot', 149), ('parking meter', 128), ('broccoli', 88), ('hair drier', 72), ('bear', 37), ('toaster', 32), ('zebra', 31)]",9826
chair,4157,2504,1653,"[('dining table', 1459), ('cup', 947), ('bottle', 773), ('tennis racket', 616), ('book', 469), ('couch', 460), ('bowl', 454), ('laptop', 454), ('cell phone', 449), ('sports ball', 444), ('knife', 432), ('tv', 411), ('handbag', 399), ('potted plant', 393), ('remote', 360), ('fork', 351), ('tie', 342), ('wine glass', 334), ('bench', 300), ('spoon', 292), ('backpack', 284), ('cake', 282), ('umbrella', 262), ('pizza', 253), ('clock', 204), ('baseball bat', 188), ('car', 180), ('vase', 179), ('baseball glove', 168), ('keyboard', 143), ('refrigerator', 141), ('mouse', 138), ('dog', 135), ('sandwich', 126), ('oven', 113), ('bed', 96), ('sink', 92), ('bicycle', 92), ('suitcase', 86), ('microwave', 82), ('hot dog', 79), ('teddy bear', 78), ('banana', 72), ('donut', 70), ('frisbee', 69), ('cat', 65), ('truck', 65), ('skateboard', 55), ('apple', 50), ('scissors', 48), ('motorcycle', 46), ('horse', 46), ('orange', 45), ('boat', 44), ('carrot', 36), ('surfboard', 33), ('kite', 30), ('bird', 29), ('broccoli', 25), ('bus', 24), ('traffic light', 21), ('elephant', 18), ('toothbrush', 16), ('train', 15), ('snowboard', 12), ('fire hydrant', 12), ('stop sign', 12), ('hair drier', 11), ('skis', 10), ('cow', 10), ('sheep', 9), ('parking meter', 8), ('airplane', 7), ('bear', 6), ('toaster', 4), ('toilet', 4), ('giraffe', 3), ('zebra', 2)]",1653
car,3357,2461,896,"[('truck', 815), ('handbag', 660), ('traffic light', 504), ('skateboard', 497), ('bicycle', 493), ('motorcycle', 447), ('backpack', 413), ('bus', 337), ('umbrella', 332), ('cell phone', 328), ('bench', 316), ('chair', 180), ('tie', 167), ('dog', 157), ('sports ball', 156), ('frisbee', 152), ('horse', 152), ('fire hydrant', 133), ('stop sign', 132), ('suitcase', 122), ('dining table', 111), ('cup', 107), ('tennis racket', 101), ('bottle', 97), ('kite', 95), ('parking meter', 88), ('potted plant', 81), ('baseball glove', 67), ('baseball bat', 66), ('surfboard', 62), ('clock', 45), ('skis', 41), ('train', 41), ('cow', 40), ('pizza', 39), ('banana', 36), ('book', 36), ('elephant', 36), ('knife', 35), ('boat', 34), ('donut', 34), ('bowl', 32), ('bird', 31), ('fork', 26), ('hot dog', 25), ('snowboard', 25), ('laptop', 24), ('sandwich', 24), ('spoon', 19), ('airplane', 19), ('cake', 18), ('teddy bear', 18), ('wine glass', 17), ('orange', 17), ('sheep', 15), ('apple', 13), ('tv', 13), ('carrot', 13), ('refrigerator', 7), ('keyboard', 6), ('couch', 6), ('scissors', 6), ('vase', 5), ('cat', 5), ('toilet', 5), ('toothbrush', 5), ('zebra', 4), ('oven', 4), ('broccoli', 4), ('remote', 4), ('microwave', 3), ('giraffe', 3), ('bed', 3), ('mouse', 2), ('sink', 2), ('hair drier', 2), ('bear', 1)]",896
tennis racket,2926,1775,1151,"[('sports ball', 1566), ('chair', 616), ('bench', 228), ('backpack', 106), ('car', 101), ('bottle', 81), ('handbag', 65), ('tie', 65), ('clock', 65), ('potted plant', 46), ('umbrella', 38), ('cell phone', 28), ('cup', 16), ('truck', 13), ('bicycle', 8), ('bus', 7), ('suitcase', 7), ('dog', 7), ('book', 6), ('laptop', 5), ('frisbee', 4), ('tv', 4), ('motorcycle', 3), ('traffic light', 3), ('airplane', 2), ('remote', 2), ('stop sign', 2), ('couch', 2), ('wine glass', 1), ('vase', 1), ('baseball glove', 1), ('hot dog', 1), ('boat', 1), ('cat', 1), ('teddy bear', 1), ('banana', 1), ('refrigerator', 1), ('horse', 1), ('fire hydrant', 1)]",1151
handbag,2896,1266,1630,"[('car', 660), ('backpack', 592), ('cell phone', 551), ('umbrella', 510), ('chair', 399), ('bench', 386), ('bicycle', 319), ('suitcase', 277), ('bottle', 269), ('truck', 250), ('traffic light', 243), ('dining table', 240), ('cup', 227), ('tie', 190), ('bus', 187), ('motorcycle', 173), ('potted plant', 139), ('book', 132), ('dog', 130), ('skateboard', 108), ('bowl', 103), ('laptop', 96), ('train', 95), ('clock', 90), ('tv', 80), ('couch', 77), ('wine glass', 72), ('fire hydrant', 67), ('tennis racket', 65), ('horse', 64), ('kite', 58), ('knife', 54), ('remote', 52), ('sports ball', 51), ('banana', 50), ('stop sign', 49), ('fork', 48), ('cake', 45), ('spoon', 45), ('boat', 45), ('hot dog', 44), ('bird', 44), ('pizza', 43), ('elephant', 43), ('frisbee', 43), ('sink', 41), ('parking meter', 41), ('teddy bear', 39), ('donut', 39), ('vase', 36), ('orange', 34), ('giraffe', 34), ('sandwich', 32), ('apple', 30), ('refrigerator', 29), ('surfboard', 28), ('bed', 27), ('oven', 25), ('airplane', 23), ('keyboard', 20), ('cow', 20), ('cat', 19), ('sheep', 18), ('microwave', 18), ('skis', 17), ('baseball bat', 16), ('carrot', 14), ('mouse', 14), ('scissors', 11), ('baseball glove', 10), ('broccoli', 9), ('snowboard', 9), ('toothbrush', 8), ('toilet', 7), ('hair drier', 6), ('zebra', 5), ('bear', 4), ('toaster', 1)]",1266
skateboard,2754,2672,82,"[('car', 497), ('bench', 276), ('backpack', 228), ('bicycle', 182), ('truck', 128), ('handbag', 108), ('traffic light', 63), ('bottle', 58), ('chair', 55), ('umbrella', 47), ('dog', 45), ('cell phone', 44), ('bus', 35), ('motorcycle', 24), ('dining table', 22), ('fire hydrant', 20), ('boat', 19), ('potted plant', 19), ('stop sign', 18), ('cup', 17), ('bird', 16), ('snowboard', 15), ('tie', 13), ('suitcase', 13), ('train', 9), ('sports ball', 9), ('laptop', 8), ('clock', 8), ('surfboard', 7), ('parking meter', 6), ('couch', 5), ('kite', 5), ('book', 4), ('bowl', 3), ('tv', 3), ('sandwich', 2), ('hot dog', 2), ('refrigerator', 2), ('airplane', 2), ('cake', 1), ('horse', 1), ('bed', 1), ('frisbee', 1), ('keyboard', 1), ('sink', 1), ('pizza', 1)]",82
sports ball,2653,1921,732,"[('tennis racket', 1566), ('baseball glove', 592), ('baseball bat', 447), ('chair', 444), ('bench', 251), ('car', 156), ('backpack', 83), ('bottle', 53), ('handbag', 51), ('clock', 42), ('umbrella', 41), ('tie', 36), ('truck', 34), ('cell phone', 28), ('potted plant', 21), ('bicycle', 19), ('frisbee', 18), ('cup', 18), ('dog', 12), ('boat', 11), ('book', 11), ('skateboard', 9), ('tv', 9), ('couch', 9), ('dining table', 8), ('suitcase', 7), ('elephant', 7), ('surfboard', 7), ('bus', 6), ('traffic light', 6), ('laptop', 5), ('motorcycle', 5), ('horse', 5), ('kite', 5), ('remote', 4), ('bowl', 3), ('bed', 2), ('mouse', 2), ('toothbrush', 2), ('stop sign', 2), ('fire hydrant', 2), ('pizza', 2), ('keyboard', 1), ('giraffe', 1), ('cake', 1), ('apple', 1), ('hair drier', 1), ('teddy bear', 1), ('microwave', 1), ('donut', 1), ('snowboard', 1)]",732
cell phone,2552,1452,1100,"[('handbag', 551), ('chair', 449), ('car', 328), ('cup', 321), ('dining table', 305), ('bottle', 263), ('backpack', 253), ('laptop', 209), ('bench', 193), ('tie', 181), ('book', 155), ('couch', 129), ('bicycle', 128), ('bowl', 113), ('truck', 111), ('tv', 107), ('potted plant', 100), ('umbrella', 99), ('wine glass', 77), ('remote', 75), ('traffic light', 67), ('keyboard', 67), ('knife', 66), ('bed', 63), ('clock', 63), ('mouse', 60), ('suitcase', 58), ('spoon', 56), ('fork', 54), ('bus', 52), ('sink', 50), ('cake', 46), ('skateboard', 44), ('dog', 44), ('motorcycle', 41), ('refrigerator', 37), ('vase', 36), ('pizza', 34), ('train', 32), ('sports ball', 28), ('tennis racket', 28), ('cat', 24), ('fire hydrant', 24), ('sandwich', 24), ('oven', 24), ('horse', 21), ('boat', 20), ('toothbrush', 20), ('teddy bear', 19), ('microwave', 18), ('donut', 17), ('toilet', 17), ('baseball bat', 16), ('bird', 14), ('stop sign', 14), ('parking meter', 11), ('baseball glove', 11), ('frisbee', 11), ('skis', 10), ('orange', 9), ('apple', 9), ('sheep', 9), ('scissors', 9), ('carrot', 8), ('giraffe', 7), ('cow', 7), ('elephant', 6), ('banana', 6), ('kite', 6), ('hot dog', 4), ('broccoli', 4), ('hair drier', 3), ('bear', 2), ('snowboard', 2), ('toaster', 1), ('surfboard', 1), ('airplane', 1)]",1100
surfboard,2457,2105,352,"[('boat', 97), ('kite', 88), ('car', 62), ('dog', 47), ('backpack', 39), ('chair', 33), ('bird', 32), ('umbrella', 29), ('handbag', 28), ('bicycle', 26), ('truck', 22), ('bench', 17), ('bottle', 13), ('clock', 11), ('cup', 7), ('sports ball', 7), ('book', 7), ('skateboard', 7), ('dining table', 6), ('snowboard', 6), ('bed', 5), ('motorcycle', 4), ('bus', 4), ('potted plant', 4), ('traffic light', 3), ('tie', 3), ('cat', 2), ('fire hydrant', 2), ('donut', 1), ('train', 1), ('pizza', 1), ('spoon', 1), ('stop sign', 1), ('skis', 1), ('airplane', 1), ('cell phone', 1), ('bowl', 1), ('vase', 1), ('tv', 1), ('couch', 1), ('remote', 1), ('teddy bear', 1), ('banana', 1), ('frisbee', 1)]",352
dining table,2431,1290,1141,"[('chair', 1459), ('cup', 1099), ('bottle', 768), ('knife', 665), ('bowl', 609), ('fork', 535), ('wine glass', 449), ('cake', 443), ('spoon', 422), ('pizza', 388), ('cell phone', 305), ('potted plant', 266), ('handbag', 240), ('couch', 239), ('book', 237), ('sandwich', 197), ('laptop', 187), ('tv', 178), ('vase', 155), ('tie', 149), ('remote', 147), ('bench', 131), ('oven', 129), ('umbrella', 126), ('refrigerator', 125), ('clock', 112), ('car', 111), ('donut', 106), ('backpack', 103), ('hot dog', 96), ('sink', 92), ('dog', 74), ('microwave', 72), ('carrot', 60), ('orange', 55), ('apple', 54), ('banana', 52), ('bicycle', 44), ('broccoli', 41), ('keyboard', 39), ('mouse', 34), ('scissors', 31), ('teddy bear', 30), ('truck', 28), ('cat', 27), ('frisbee', 23), ('skateboard', 22), ('suitcase', 21), ('boat', 17), ('motorcycle', 17), ('bed', 15), ('bird', 11), ('traffic light', 10), ('horse', 10), ('sports ball', 8), ('bus', 7), ('parking meter', 7), ('toothbrush', 7), ('surfboard', 6), ('cow', 6), ('toaster', 5), ('elephant', 4), ('bear', 4), ('kite', 3), ('fire hydrant', 3), ('hair drier', 2), ('stop sign', 2), ('baseball bat', 2), ('airplane', 2), ('zebra', 1), ('snowboard', 1), ('toilet', 1), ('sheep', 1), ('giraffe', 1), ('train', 1)]",1141
bottle,2395,1388,1007,"[('cup', 791), ('chair', 773), ('dining table', 768), ('bowl', 574), ('knife', 403), ('wine glass', 377), ('spoon', 315), ('sink', 285), ('oven', 281), ('handbag', 269), ('cell phone', 263), ('refrigerator', 246), ('book', 230), ('fork', 222), ('potted plant', 203), ('pizza', 199), ('couch', 185), ('backpack', 170), ('laptop', 158), ('microwave', 153), ('remote', 152), ('tv', 148), ('cake', 145), ('vase', 134), ('tie', 129), ('clock', 128), ('bench', 121), ('sandwich', 106), ('car', 97), ('umbrella', 83), ('tennis racket', 81), ('dog', 79), ('bicycle', 72), ('hot dog', 72), ('bed', 66), ('banana', 64), ('skateboard', 58), ('orange', 53), ('sports ball', 53), ('apple', 52), ('donut', 50), ('truck', 49), ('toothbrush', 42), ('toilet', 42), ('keyboard', 41), ('carrot', 39), ('scissors', 38), ('suitcase', 37), ('mouse', 36), ('baseball bat', 34), ('cat', 33), ('frisbee', 32), ('teddy bear', 31), ('motorcycle', 27), ('broccoli', 27), ('baseball glove', 25), ('boat', 25), ('toaster', 19), ('bus', 14), ('bird', 13), ('surfboard', 13), ('train', 13), ('traffic light', 12), ('hair drier', 12), ('horse', 9), ('elephant', 8), ('sheep', 7), ('stop sign', 7), ('cow', 6), ('skis', 6), ('fire hydrant', 5), ('giraffe', 4), ('kite', 4), ('parking meter', 3), ('snowboard', 3), ('airplane', 2), ('bear', 1)]",1007
backpack,2381,1764,617,"[('handbag', 592), ('car', 413), ('skis', 333), ('bicycle', 310), ('chair', 284), ('bench', 271), ('cell phone', 253), ('skateboard', 228), ('suitcase', 221), ('umbrella', 189), ('bottle', 170), ('truck', 161), ('traffic light', 147), ('motorcycle', 134), ('bus', 130), ('tennis racket', 106), ('dog', 106), ('dining table', 103), ('cup', 98), ('snowboard', 98), ('laptop', 96), ('tie', 89), ('sports ball', 83), ('book', 78), ('frisbee', 75), ('train', 68), ('potted plant', 68), ('tv', 64), ('kite', 53), ('couch', 53), ('clock', 51), ('fire hydrant', 50), ('boat', 42), ('remote', 42), ('horse', 40), ('surfboard', 39), ('stop sign', 37), ('baseball bat', 29), ('bowl', 28), ('baseball glove', 27), ('banana', 26), ('bed', 25), ('bird', 25), ('teddy bear', 23), ('parking meter', 22), ('vase', 19), ('elephant', 18), ('hot dog', 18), ('keyboard', 17), ('knife', 16), ('giraffe', 16), ('refrigerator', 15), ('cake', 14), ('mouse', 14), ('airplane', 14), ('wine glass', 13), ('sheep', 13), ('cow', 12), ('spoon', 12), ('apple', 12), ('sandwich', 11), ('sink', 11), ('pizza', 10), ('oven', 10), ('cat', 10), ('fork', 9), ('toilet', 8), ('orange', 8), ('donut', 8), ('scissors', 7), ('carrot', 6), ('microwave', 5), ('bear', 3), ('toothbrush', 3), ('broccoli', 2), ('zebra', 1)]",617
cup,2303,1255,1048,"[('dining table', 1099), ('chair', 947), ('bottle', 791), ('bowl', 609), ('knife', 513), ('spoon', 409), ('fork', 407), ('wine glass', 348), ('cell phone', 321), ('pizza', 264), ('cake', 256), ('book', 249), ('couch', 247), ('potted plant', 230), ('laptop', 230), ('handbag', 227), ('oven', 205), ('tv', 201), ('sink', 201), ('remote', 178), ('vase', 164), ('tie', 160), ('refrigerator', 158), ('sandwich', 158), ('microwave', 128), ('clock', 120), ('car', 107), ('donut', 104), ('bench', 102), ('backpack', 98), ('keyboard', 85), ('hot dog', 74), ('mouse', 69), ('umbrella', 69), ('dog', 68), ('bed', 50), ('banana', 48), ('carrot', 48), ('orange', 46), ('cat', 45), ('bicycle', 40), ('apple', 39), ('scissors', 38), ('broccoli', 34), ('teddy bear', 28), ('baseball bat', 27), ('toothbrush', 27), ('truck', 26), ('suitcase', 23), ('baseball glove', 22), ('bird', 21), ('sports ball', 18), ('skateboard', 17), ('tennis racket', 16), ('frisbee', 15), ('toilet', 13), ('toaster', 12), ('boat', 12), ('traffic light', 12), ('motorcycle', 11), ('fire hydrant', 9), ('horse', 7), ('bus', 7), ('surfboard', 7), ('stop sign', 6), ('hair drier', 6), ('sheep', 5), ('cow', 4), ('kite', 4), ('train', 3), ('giraffe', 3), ('parking meter', 3), ('airplane', 2), ('elephant', 2), ('skis', 2), ('zebra', 1), ('bear', 1), ('snowboard', 1)]",1048
tie,2199,1926,273,"[('chair', 342), ('handbag', 190), ('cell phone', 181), ('car', 167), ('cup', 160), ('dining table', 149), ('bottle', 129), ('book', 108), ('backpack', 89), ('wine glass', 84), ('bench', 72), ('potted plant', 67), ('horse', 66), ('tennis racket', 65), ('truck', 65), ('umbrella', 63), ('suitcase', 59), ('couch', 59), ('bowl', 58), ('tv', 57), ('cake', 55), ('clock', 55), ('knife', 55), ('bicycle', 46), ('laptop', 45), ('traffic light', 37), ('sports ball', 36), ('vase', 32), ('motorcycle', 30), ('bus', 29), ('fork', 27), ('train', 26), ('spoon', 24), ('dog', 24), ('bed', 20), ('baseball bat', 18), ('remote', 18), ('baseball glove', 16), ('keyboard', 13), ('refrigerator', 13), ('skateboard', 13), ('sink', 13), ('teddy bear', 13), ('scissors', 12), ('airplane', 12), ('banana', 12), ('pizza', 11), ('cow', 11), ('sandwich', 8), ('cat', 7), ('toilet', 7), ('oven', 7), ('boat', 7), ('donut', 6), ('bird', 6), ('sheep', 6), ('mouse', 6), ('carrot', 6), ('hot dog', 6), ('apple', 6), ('frisbee', 5), ('parking meter', 4), ('stop sign', 4), ('kite', 3), ('zebra', 3), ('microwave', 3), ('toothbrush', 3), ('skis', 3), ('surfboard', 3), ('elephant', 2), ('fire hydrant', 2), ('broccoli', 2), ('orange', 2), ('snowboard', 1)]",273
bench,2114,1452,662,"[('handbag', 386), ('car', 316), ('chair', 300), ('skateboard', 276), ('backpack', 271), ('sports ball', 251), ('tennis racket', 228), ('baseball bat', 211), ('cell phone', 193), ('baseball glove', 183), ('bicycle', 143), ('umbrella', 135), ('dining table', 131), ('bottle', 121), ('dog', 108), ('cup', 102), ('frisbee', 83), ('truck', 81), ('book', 78), ('potted plant', 77), ('tie', 72), ('suitcase', 63), ('boat', 49), ('kite', 44), ('traffic light', 43), ('bird', 43), ('elephant', 39), ('motorcycle', 38), ('train', 38), ('laptop', 37), ('bus', 36), ('bowl', 35), ('clock', 35), ('skis', 32), ('pizza', 29), ('fork', 28), ('sandwich', 25), ('knife', 24), ('horse', 23), ('hot dog', 20), ('spoon', 19), ('surfboard', 17), ('snowboard', 17), ('couch', 16), ('cat', 15), ('wine glass', 14), ('fire hydrant', 13), ('teddy bear', 12), ('tv', 11), ('parking meter', 11), ('cake', 11), ('stop sign', 11), ('banana', 11), ('donut', 10), ('airplane', 9), ('sheep', 8), ('cow', 8), ('giraffe', 8), ('apple', 7), ('orange', 5), ('vase', 4), ('scissors', 4), ('toothbrush', 4), ('remote', 2), ('broccoli', 2), ('oven', 2), ('keyboard', 2), ('refrigerator', 2), ('sink', 1), ('mouse', 1), ('bed', 1), ('carrot', 1), ('microwave', 1), ('bear', 1), ('zebra', 1)]",662
skis,1622,1253,369,"[('backpack', 333), ('snowboard', 164), ('car', 41), ('bench', 32), ('dog', 31), ('handbag', 17), ('truck', 13), ('boat', 11), ('chair', 10), ('cell phone', 10), ('bottle', 6), ('traffic light', 5), ('horse', 5), ('stop sign', 5), ('bus', 4), ('tie', 3), ('tv', 3), ('motorcycle', 2), ('clock', 2), ('potted plant', 2), ('kite', 2), ('baseball glove', 2), ('teddy bear', 2), ('parking meter', 2), ('bicycle', 2), ('couch', 2), ('cup', 2), ('orange', 1), ('book', 1), ('suitcase', 1), ('surfboard', 1), ('banana', 1), ('airplane', 1), ('umbrella', 1), ('cat', 1), ('bed', 1), ('toothbrush', 1), ('laptop', 1)]",369
umbrella,1547,744,803,"[('handbag', 510), ('car', 332), ('chair', 262), ('backpack', 189), ('bicycle', 143), ('bench', 135), ('dining table', 126), ('truck', 102), ('cell phone', 99), ('traffic light', 92), ('bottle', 83), ('motorcycle', 72), ('cup', 69), ('tie', 63), ('bus', 61), ('potted plant', 56), ('boat', 56), ('skateboard', 47), ('dog', 43), ('sports ball', 41), ('suitcase', 38), ('tennis racket', 38), ('frisbee', 34), ('banana', 32), ('fire hydrant', 30), ('horse', 30), ('surfboard', 29), ('bowl', 27), ('book', 25), ('wine glass', 25), ('spoon', 21), ('clock', 21), ('fork', 20), ('kite', 20), ('hot dog', 19), ('knife', 19), ('elephant', 18), ('train', 16), ('bird', 16), ('orange', 15), ('tv', 14), ('sandwich', 14), ('stop sign', 14), ('carrot', 13), ('cow', 12), ('baseball glove', 11), ('apple', 11), ('baseball bat', 10), ('laptop', 10), ('parking meter', 10), ('pizza', 10), ('vase', 9), ('teddy bear', 7), ('donut', 7), ('couch', 6), ('cake', 6), ('cat', 5), ('bed', 4), ('refrigerator', 4), ('broccoli', 4), ('scissors', 4), ('sheep', 3), ('mouse', 2), ('zebra', 2), ('toothbrush', 2), ('remote', 1), ('airplane', 1), ('snowboard', 1), ('skis', 1), ('microwave', 1), ('oven', 1), ('giraffe', 1)]",744
truck,1355,1059,296,"[('car', 815), ('handbag', 250), ('motorcycle', 201), ('traffic light', 199), ('bicycle', 173), ('backpack', 161), ('bus', 150), ('skateboard', 128), ('cell phone', 111), ('umbrella', 102), ('horse', 93), ('bench', 81), ('tie', 65), ('chair', 65), ('dog', 62), ('fire hydrant', 56), ('suitcase', 53), ('stop sign', 49), ('bottle', 49), ('frisbee', 42), ('airplane', 41), ('sports ball', 34), ('kite', 32), ('parking meter', 31), ('potted plant', 31), ('cow', 30), ('dining table', 28), ('cup', 26), ('banana', 24), ('surfboard', 22), ('clock', 19), ('sheep', 17), ('elephant', 17), ('baseball bat', 16), ('train', 14), ('boat', 14), ('skis', 13), ('tennis racket', 13), ('bowl', 12), ('baseball glove', 12), ('bird', 11), ('snowboard', 10), ('orange', 10), ('apple', 8), ('hot dog', 8), ('pizza', 8), ('book', 7), ('spoon', 7), ('donut', 6), ('cake', 5), ('carrot', 5), ('laptop', 5), ('knife', 5), ('tv', 4), ('sandwich', 4), ('bear', 3), ('refrigerator', 3), ('fork', 3), ('keyboard', 2), ('teddy bear', 2), ('scissors', 2), ('wine glass', 2), ('microwave', 2), ('toilet', 1), ('vase', 1), ('bed', 1), ('remote', 1), ('broccoli', 1), ('couch', 1), ('cat', 1), ('toothbrush', 1), ('giraffe', 1)]",296
bowl,1341,669,672,"[('cup', 609), ('dining table', 609), ('bottle', 574), ('spoon', 460), ('chair', 454), ('knife', 407), ('oven', 296), ('fork', 232), ('sink', 227), ('wine glass', 208), ('refrigerator', 191), ('cake', 157), ('microwave', 149), ('potted plant', 141), ('book', 128), ('pizza', 122), ('cell phone', 113), ('handbag', 103), ('vase', 100), ('sandwich', 99), ('couch', 92), ('banana', 80), ('tv', 75), ('clock', 71), ('orange', 69), ('carrot', 63), ('laptop', 58), ('tie', 58), ('apple', 55), ('dog', 48), ('remote', 46), ('broccoli', 45), ('donut', 38), ('bench', 35), ('car', 32), ('backpack', 28), ('hot dog', 28), ('scissors', 27), ('umbrella', 27), ('cat', 20), ('keyboard', 18), ('bed', 17), ('bicycle', 14), ('truck', 12), ('teddy bear', 11), ('toaster', 11), ('toothbrush', 9), ('bird', 9), ('mouse', 9), ('toilet', 8), ('boat', 8), ('suitcase', 7), ('horse', 6), ('motorcycle', 5), ('elephant', 5), ('giraffe', 4), ('hair drier', 3), ('skateboard', 3), ('frisbee', 3), ('sports ball', 3), ('sheep', 2), ('stop sign', 2), ('traffic light', 1), ('bear', 1), ('cow', 1), ('train', 1), ('surfboard', 1), ('kite', 1), ('bus', 1)]",669
bicycle,1312,964,348,"[('car', 493), ('handbag', 319), ('backpack', 310), ('skateboard', 182), ('motorcycle', 179), ('truck', 173), ('traffic light', 168), ('bench', 143), ('umbrella', 143), ('cell phone', 128), ('bus', 125), ('chair', 92), ('bottle', 72), ('dog', 71), ('suitcase', 51), ('potted plant', 48), ('stop sign', 47), ('tie', 46), ('dining table', 44), ('cup', 40), ('banana', 39), ('train', 36), ('kite', 33), ('fire hydrant', 30), ('boat', 29), ('surfboard', 26), ('book', 25), ('parking meter', 23), ('bird', 20), ('frisbee', 20), ('clock', 19), ('sports ball', 19), ('horse', 19), ('cow', 17), ('bowl', 14), ('tv', 14), ('elephant', 14), ('sandwich', 11), ('apple', 11), ('laptop', 10), ('knife', 9), ('tennis racket', 8), ('orange', 8), ('baseball glove', 7), ('teddy bear', 7), ('spoon', 6), ('couch', 6), ('baseball bat', 6), ('cake', 5), ('fork', 5), ('donut', 5), ('refrigerator', 5), ('cat', 5), ('sheep', 5), ('wine glass', 5), ('hot dog', 5), ('pizza', 4), ('carrot', 4), ('bed', 4), ('remote', 3), ('scissors', 3), ('toothbrush', 3), ('mouse', 2), ('broccoli', 2), ('airplane', 2), ('skis', 2), ('microwave', 1), ('oven', 1), ('sink', 1), ('keyboard', 1), ('bear', 1), ('vase', 1), ('zebra', 1)]",348
motorcycle,1283,1087,196,"[('car', 447), ('truck', 201), ('bicycle', 179), ('handbag', 173), ('backpack', 134), ('traffic light', 100), ('bus', 82), ('umbrella', 72), ('dog', 49), ('chair', 46), ('cell phone', 41), ('bench', 38), ('tie', 30), ('banana', 29), ('bottle', 27), ('potted plant', 27), ('cow', 25), ('skateboard', 24), ('stop sign', 23), ('elephant', 19), ('suitcase', 18), ('dining table', 17), ('clock', 12), ('cup', 11), ('book', 11), ('fire hydrant', 10), ('horse', 9), ('apple', 8), ('bird', 8), ('airplane', 6), ('sports ball', 5), ('parking meter', 5), ('bowl', 5), ('teddy bear', 5), ('surfboard', 4), ('boat', 4), ('train', 4), ('kite', 4), ('sheep', 4), ('orange', 4), ('frisbee', 3), ('knife', 3), ('tennis racket', 3), ('laptop', 3), ('cat', 3), ('donut', 2), ('sandwich', 2), ('refrigerator', 2), ('skis', 2), ('carrot', 2), ('tv', 2), ('baseball bat', 2), ('snowboard', 1), ('broccoli', 1), ('scissors', 1), ('spoon', 1), ('baseball glove', 1), ('wine glass', 1), ('hair drier', 1), ('mouse', 1)]",196
baseball glove,1270,1226,44,"[('baseball bat', 789), ('sports ball', 592), ('bench', 183), ('chair', 168), ('car', 67), ('backpack', 27), ('bottle', 25), ('cup', 22), ('tie', 16), ('truck', 12), ('umbrella', 11), ('cell phone', 11), ('handbag', 10), ('dog', 7), ('bicycle', 7), ('tv', 5), ('book', 3), ('traffic light', 3), ('bus', 3), ('clock', 3), ('skis', 2), ('snowboard', 2), ('boat', 2), ('potted plant', 2), ('frisbee', 1), ('suitcase', 1), ('couch', 1), ('fire hydrant', 1), ('bird', 1), ('tennis racket', 1), ('apple', 1), ('motorcycle', 1), ('horse', 1)]",44
baseball bat,1245,1178,67,"[('baseball glove', 789), ('sports ball', 447), ('bench', 211), ('chair', 188), ('car', 66), ('bottle', 34), ('backpack', 29), ('cup', 27), ('tie', 18), ('handbag', 16), ('cell phone', 16), ('truck', 16), ('umbrella', 10), ('dog', 6), ('bicycle', 6), ('tv', 6), ('clock', 5), ('book', 4), ('fire hydrant', 3), ('bus', 3), ('suitcase', 2), ('dining table', 2), ('motorcycle', 2), ('frisbee', 1), ('donut', 1), ('boat', 1), ('apple', 1), ('cat', 1), ('couch', 1), ('potted plant', 1), ('traffic light', 1), ('bird', 1), ('wine glass', 1)]",67
book,1228,710,518,"[('chair', 469), ('couch', 300), ('cup', 249), ('tv', 248), ('remote', 246), ('dining table', 237), ('bottle', 230), ('laptop', 219), ('bed', 158), ('cell phone', 155), ('potted plant', 146), ('handbag', 132), ('bowl', 128), ('tie', 108), ('vase', 95), ('keyboard', 91), ('mouse', 89), ('clock', 84), ('bench', 78), ('backpack', 78), ('dog', 72), ('wine glass', 66), ('knife', 57), ('spoon', 52), ('oven', 51), ('cat', 51), ('refrigerator', 49), ('sink', 39), ('cake', 38), ('teddy bear', 37), ('suitcase', 36), ('car', 36), ('microwave', 35), ('fork', 33), ('umbrella', 25), ('bicycle', 25), ('pizza', 23), ('scissors', 21), ('donut', 19), ('toothbrush', 18), ('banana', 15), ('sandwich', 14), ('toilet', 11), ('motorcycle', 11), ('sports ball', 11), ('apple', 10), ('train', 9), ('bird', 7), ('truck', 7), ('surfboard', 7), ('bus', 6), ('orange', 6), ('tennis racket', 6), ('traffic light', 6), ('carrot', 6), ('broccoli', 5), ('hot dog', 5), ('baseball bat', 4), ('horse', 4), ('fire hydrant', 4), ('hair drier', 4), ('toaster', 4), ('skateboard', 4), ('baseball glove', 3), ('boat', 3), ('bear', 3), ('elephant', 2), ('stop sign', 2), ('snowboard', 2), ('frisbee', 2), ('airplane', 2), ('sheep', 1), ('skis', 1), ('kite', 1), ('giraffe', 1)]",518
couch,1153,652,501,"[('remote', 503), ('chair', 460), ('book', 300), ('cup', 247), ('dining table', 239), ('tv', 227), ('laptop', 209), ('bottle', 185), ('potted plant', 176), ('cell phone', 129), ('dog', 113), ('vase', 97), ('bowl', 92), ('clock', 77), ('handbag', 77), ('cat', 76), ('wine glass', 75), ('tie', 59), ('bed', 54), ('backpack', 53), ('teddy bear', 51), ('fork', 46), ('cake', 44), ('keyboard', 42), ('knife', 40), ('refrigerator', 37), ('mouse', 29), ('spoon', 28), ('pizza', 28), ('suitcase', 20), ('oven', 19), ('bench', 16), ('donut', 16), ('microwave', 16), ('toothbrush', 15), ('sink', 12), ('sandwich', 12), ('apple', 9), ('sports ball', 9), ('scissors', 9), ('hot dog', 9), ('hair drier', 8), ('carrot', 8), ('bird', 7), ('banana', 7), ('orange', 7), ('bicycle', 6), ('car', 6), ('umbrella', 6), ('skateboard', 5), ('frisbee', 4), ('snowboard', 3), ('broccoli', 3), ('train', 3), ('boat', 2), ('tennis racket', 2), ('skis', 2), ('stop sign', 1), ('baseball glove', 1), ('bear', 1), ('kite', 1), ('truck', 1), ('baseball bat', 1), ('surfboard', 1)]",501
dog,1146,711,435,"[('car', 157), ('chair', 135), ('handbag', 130), ('frisbee', 119), ('couch', 113), ('bench', 108), ('backpack', 106), ('bottle', 79), ('dining table', 74), ('book', 72), ('bicycle', 71), ('cup', 68), ('truck', 62), ('bed', 62), ('boat', 50), ('motorcycle', 49), ('bowl', 48), ('surfboard', 47), ('potted plant', 45), ('remote', 45), ('skateboard', 45), ('cell phone', 44), ('umbrella', 43), ('laptop', 42), ('horse', 39), ('sheep', 36), ('tv', 33), ('skis', 31), ('suitcase', 29), ('clock', 28), ('oven', 24), ('kite', 24), ('tie', 24), ('sink', 23), ('cat', 23), ('traffic light', 21), ('refrigerator', 21), ('knife', 21), ('vase', 19), ('cow', 19), ('cake', 18), ('bird', 17), ('bus', 16), ('spoon', 16), ('orange', 13), ('sports ball', 12), ('teddy bear', 12), ('microwave', 11), ('keyboard', 10), ('pizza', 9), ('stop sign', 8), ('fork', 8), ('mouse', 7), ('parking meter', 7), ('wine glass', 7), ('baseball glove', 7), ('banana', 7), ('tennis racket', 7), ('fire hydrant', 6), ('apple', 6), ('baseball bat', 6), ('hot dog', 6), ('snowboard', 5), ('donut', 5), ('carrot', 5), ('hair drier', 5), ('toilet', 5), ('toothbrush', 5), ('scissors', 4), ('sandwich', 3), ('elephant', 3), ('toaster', 1), ('bear', 1), ('airplane', 1)]",435
frisbee,1142,904,238,"[('car', 152), ('dog', 119), ('bench', 83), ('backpack', 75), ('chair', 69), ('handbag', 43), ('truck', 42), ('umbrella', 34), ('bottle', 32), ('boat', 28), ('dining table', 23), ('bicycle', 20), ('sports ball', 18), ('cup', 15), ('cell phone', 11), ('bird', 9), ('clock', 8), ('potted plant', 8), ('tie', 5), ('tennis racket', 4), ('couch', 4), ('motorcycle', 3), ('laptop', 3), ('bus', 3), ('bowl', 3), ('traffic light', 3), ('kite', 3), ('suitcase', 2), ('tv', 2), ('book', 2), ('cake', 2), ('pizza', 2), ('parking meter', 2), ('fire hydrant', 2), ('horse', 1), ('skateboard', 1), ('baseball bat', 1), ('baseball glove', 1), ('remote', 1), ('knife', 1), ('cow', 1), ('stop sign', 1), ('bear', 1), ('banana', 1), ('wine glass', 1), ('airplane', 1), ('sandwich', 1), ('surfboard', 1)]",238
knife,1079,539,540,"[('dining table', 665), ('cup', 513), ('chair', 432), ('bowl', 407), ('bottle', 403), ('fork', 393), ('cake', 284), ('spoon', 266), ('pizza', 224), ('wine glass', 202), ('oven', 158), ('sink', 125), ('potted plant', 91), ('refrigerator', 89), ('sandwich', 89), ('microwave', 74), ('cell phone', 66), ('book', 57), ('tie', 55), ('handbag', 54), ('vase', 54), ('carrot', 54), ('clock', 44), ('apple', 43), ('couch', 40), ('tv', 37), ('banana', 36), ('car', 35), ('broccoli', 33), ('orange', 32), ('scissors', 25), ('bench', 24), ('donut', 24), ('dog', 21), ('umbrella', 19), ('laptop', 18), ('hot dog', 18), ('backpack', 16), ('bicycle', 9), ('boat', 8), ('toaster', 8), ('remote', 8), ('bed', 5), ('cat', 5), ('truck', 5), ('keyboard', 4), ('bird', 4), ('mouse', 4), ('horse', 3), ('stop sign', 3), ('motorcycle', 3), ('teddy bear', 3), ('suitcase', 2), ('toothbrush', 2), ('sheep', 2), ('cow', 1), ('bear', 1), ('frisbee', 1), ('bus', 1)]",539
remote,1059,691,368,"[('couch', 503), ('chair', 360), ('tv', 321), ('book', 246), ('cup', 178), ('bottle', 152), ('dining table', 147), ('potted plant', 129), ('laptop', 105), ('cell phone', 75), ('vase', 63), ('clock', 56), ('bed', 53), ('handbag', 52), ('wine glass', 49), ('keyboard', 49), ('bowl', 46), ('dog', 45), ('backpack', 42), ('cat', 34), ('mouse', 30), ('refrigerator', 21), ('teddy bear', 18), ('tie', 18), ('microwave', 16), ('oven', 15), ('sink', 11), ('spoon', 10), ('cake', 10), ('fork', 8), ('knife', 8), ('suitcase', 6), ('pizza', 5), ('sandwich', 5), ('sports ball', 4), ('car', 4), ('bicycle', 3), ('banana', 3), ('orange', 3), ('scissors', 3), ('toothbrush', 3), ('bench', 2), ('bird', 2), ('donut', 2), ('airplane', 2), ('tennis racket', 2), ('snowboard', 2), ('carrot', 2), ('hot dog', 1), ('umbrella', 1), ('boat', 1), ('frisbee', 1), ('truck', 1), ('toilet', 1), ('surfboard', 1)]",368
horse,1055,717,338,"[('car', 152), ('truck', 93), ('tie', 66), ('handbag', 64), ('cow', 50), ('chair', 46), ('backpack', 40), ('dog', 39), ('bus', 38), ('potted plant', 33), ('umbrella', 30), ('traffic light', 30), ('bench', 23), ('cell phone', 21), ('bicycle', 19), ('sheep', 18), ('dining table', 10), ('clock', 10), ('motorcycle', 9), ('bottle', 9), ('stop sign', 8), ('boat', 8), ('cup', 7), ('bird', 7), ('bowl', 6), ('fire hydrant', 6), ('sports ball', 5), ('suitcase', 5), ('skis', 5), ('book', 4), ('carrot', 4), ('tv', 4), ('knife', 3), ('train', 3), ('banana', 3), ('zebra', 3), ('elephant', 2), ('spoon', 2), ('teddy bear', 2), ('cake', 2), ('oven', 2), ('frisbee', 1), ('apple', 1), ('skateboard', 1), ('bed', 1), ('vase', 1), ('broccoli', 1), ('orange', 1), ('sink', 1), ('cat', 1), ('refrigerator', 1), ('parking meter', 1), ('baseball glove', 1), ('tennis racket', 1), ('wine glass', 1)]",338
snowboard,1042,948,94,"[('skis', 164), ('backpack', 98), ('car', 25), ('bench', 17), ('skateboard', 15), ('chair', 12), ('truck', 10), ('handbag', 9), ('kite', 7), ('surfboard', 6), ('dog', 5), ('boat', 5), ('couch', 3), ('bottle', 3), ('bed', 2), ('baseball glove', 2), ('remote', 2), ('potted plant', 2), ('book', 2), ('traffic light', 2), ('cell phone', 2), ('stop sign', 2), ('motorcycle', 1), ('fire hydrant', 1), ('keyboard', 1), ('dining table', 1), ('tie', 1), ('umbrella', 1), ('teddy bear', 1), ('cup', 1), ('bus', 1), ('sports ball', 1), ('clock', 1), ('tv', 1)]",94
laptop,1024,648,376,"[('chair', 454), ('cup', 230), ('book', 219), ('cell phone', 209), ('couch', 209), ('tv', 195), ('dining table', 187), ('keyboard', 165), ('bottle', 158), ('mouse', 153), ('bed', 119), ('remote', 105), ('backpack', 96), ('handbag', 96), ('potted plant', 90), ('bowl', 58), ('cat', 51), ('clock', 50), ('wine glass', 45), ('tie', 45), ('dog', 42), ('bench', 37), ('vase', 34), ('refrigerator', 30), ('spoon', 26), ('suitcase', 25), ('car', 24), ('sink', 24), ('oven', 18), ('knife', 18), ('scissors', 14), ('teddy bear', 14), ('fork', 14), ('microwave', 12), ('pizza', 11), ('bicycle', 10), ('apple', 10), ('umbrella', 10), ('banana', 9), ('sandwich', 8), ('skateboard', 8), ('cake', 8), ('orange', 6), ('donut', 6), ('traffic light', 6), ('sports ball', 5), ('tennis racket', 5), ('truck', 5), ('boat', 4), ('carrot', 3), ('cow', 3), ('frisbee', 3), ('toothbrush', 3), ('bird', 3), ('motorcycle', 3), ('bus', 3), ('parking meter', 3), ('toilet', 3), ('sheep', 2), ('toaster', 2), ('train', 2), ('hair drier', 1), ('airplane', 1), ('hot dog', 1), ('skis', 1), ('broccoli', 1)]",376
tv,980,664,316,"[('chair', 411), ('remote', 321), ('book', 248), ('couch', 227), ('cup', 201), ('laptop', 195), ('dining table', 178), ('keyboard', 167), ('bottle', 148), ('potted plant', 115), ('mouse', 113), ('cell phone', 107), ('handbag', 80), ('clock', 79), ('bowl', 75), ('backpack', 64), ('vase', 60), ('tie', 57), ('wine glass', 51), ('bed', 46), ('cake', 38), ('refrigerator', 37), ('knife', 37), ('suitcase', 34), ('dog', 33), ('fork', 30), ('spoon', 26), ('pizza', 26), ('cat', 25), ('oven', 23), ('sink', 20), ('teddy bear', 20), ('microwave', 19), ('umbrella', 14), ('bicycle', 14), ('car', 13), ('donut', 13), ('sandwich', 13), ('bench', 11), ('toothbrush', 10), ('scissors', 10), ('apple', 10), ('banana', 9), ('sports ball', 9), ('hot dog', 8), ('orange', 6), ('boat', 6), ('baseball bat', 6), ('broccoli', 5), ('traffic light', 5), ('baseball glove', 5), ('bird', 4), ('cow', 4), ('truck', 4), ('tennis racket', 4), ('horse', 4), ('carrot', 4), ('train', 3), ('skateboard', 3), ('skis', 3), ('toilet', 3), ('frisbee', 2), ('bus', 2), ('hair drier', 2), ('motorcycle', 2), ('sheep', 1), ('airplane', 1), ('fire hydrant', 1), ('snowboard', 1), ('surfboard', 1), ('toaster', 1)]",316
potted plant,975,533,442,"[('chair', 393), ('dining table', 266), ('cup', 230), ('bottle', 203), ('couch', 176), ('vase', 152), ('book', 146), ('bowl', 141), ('handbag', 139), ('remote', 129), ('tv', 115), ('cell phone', 100), ('knife', 91), ('laptop', 90), ('wine glass', 86), ('car', 81), ('bench', 77), ('fork', 69), ('spoon', 68), ('backpack', 68), ('tie', 67), ('oven', 58), ('sink', 58), ('umbrella', 56), ('clock', 55), ('refrigerator', 50), ('bicycle', 48), ('tennis racket', 46), ('dog', 45), ('pizza', 44), ('cake', 43), ('microwave', 41), ('horse', 33), ('keyboard', 32), ('truck', 31), ('cat', 30), ('sandwich', 29), ('mouse', 29), ('motorcycle', 27), ('bed', 26), ('suitcase', 22), ('sports ball', 21), ('traffic light', 20), ('orange', 20), ('teddy bear', 20), ('skateboard', 19), ('banana', 18), ('apple', 15), ('bus', 13), ('carrot', 12), ('hot dog', 12), ('fire hydrant', 12), ('donut', 10), ('boat', 9), ('toothbrush', 8), ('bird', 8), ('scissors', 8), ('frisbee', 8), ('stop sign', 6), ('elephant', 6), ('train', 5), ('kite', 5), ('parking meter', 4), ('broccoli', 4), ('surfboard', 4), ('toilet', 4), ('cow', 3), ('skis', 2), ('toaster', 2), ('snowboard', 2), ('baseball glove', 2), ('zebra', 2), ('sheep', 1), ('giraffe', 1), ('airplane', 1), ('baseball bat', 1)]",442
kite,919,689,230,"[('car', 95), ('surfboard', 88), ('handbag', 58), ('backpack', 53), ('bench', 44), ('boat', 37), ('bicycle', 33), ('truck', 32), ('chair', 30), ('dog', 24), ('umbrella', 20), ('bird', 11), ('bus', 9), ('snowboard', 7), ('cell phone', 6), ('sports ball', 5), ('potted plant', 5), ('skateboard', 5), ('traffic light', 4), ('cup', 4), ('clock', 4), ('bottle', 4), ('wine glass', 4), ('motorcycle', 4), ('tie', 3), ('dining table', 3), ('frisbee', 3), ('apple', 2), ('stop sign', 2), ('skis', 2), ('suitcase', 2), ('refrigerator', 2), ('train', 2), ('banana', 1), ('couch', 1), ('book', 1), ('scissors', 1), ('fire hydrant', 1), ('bowl', 1), ('vase', 1), ('teddy bear', 1), ('keyboard', 1), ('airplane', 1)]",230
wine glass,797,416,381,"[('dining table', 449), ('bottle', 377), ('cup', 348), ('chair', 334), ('bowl', 208), ('knife', 202), ('fork', 177), ('spoon', 124), ('potted plant', 86), ('tie', 84), ('pizza', 77), ('cell phone', 77), ('cake', 76), ('couch', 75), ('handbag', 72), ('book', 66), ('vase', 56), ('tv', 51), ('remote', 49), ('sandwich', 47), ('laptop', 45), ('oven', 43), ('sink', 43), ('clock', 33), ('refrigerator', 31), ('umbrella', 25), ('microwave', 20), ('carrot', 17), ('car', 17), ('orange', 15), ('bench', 14), ('backpack', 13), ('apple', 13), ('keyboard', 12), ('broccoli', 10), ('banana', 9), ('donut', 8), ('cat', 8), ('mouse', 7), ('bed', 7), ('dog', 7), ('scissors', 7), ('teddy bear', 7), ('boat', 6), ('hot dog', 5), ('bicycle', 5), ('kite', 4), ('toaster', 3), ('fire hydrant', 3), ('truck', 2), ('bird', 2), ('tennis racket', 1), ('bear', 1), ('toothbrush', 1), ('train', 1), ('stop sign', 1), ('parking meter', 1), ('suitcase', 1), ('toilet', 1), ('motorcycle', 1), ('frisbee', 1), ('baseball bat', 1), ('horse', 1)]",381
spoon,747,357,390,"[('bowl', 460), ('dining table', 422), ('cup', 409), ('bottle', 315), ('chair', 292), ('knife', 266), ('fork', 212), ('oven', 179), ('cake', 142), ('wine glass', 124), ('sink', 108), ('refrigerator', 80), ('sandwich', 69), ('potted plant', 68), ('pizza', 59), ('cell phone', 56), ('microwave', 55), ('book', 52), ('handbag', 45), ('vase', 38), ('carrot', 37), ('clock', 35), ('donut', 28), ('couch', 28), ('banana', 28), ('laptop', 26), ('tv', 26), ('broccoli', 25), ('tie', 24), ('orange', 22), ('umbrella', 21), ('apple', 21), ('bench', 19), ('car', 19), ('dog', 16), ('hot dog', 15), ('backpack', 12), ('toaster', 11), ('scissors', 11), ('remote', 10), ('bed', 7), ('cat', 7), ('keyboard', 7), ('truck', 7), ('bicycle', 6), ('bird', 4), ('suitcase', 2), ('horse', 2), ('teddy bear', 2), ('sheep', 2), ('toothbrush', 2), ('surfboard', 1), ('boat', 1), ('motorcycle', 1), ('stop sign', 1)]",357
clock,739,472,267,"[('chair', 204), ('bottle', 128), ('cup', 120), ('dining table', 112), ('handbag', 90), ('book', 84), ('tv', 79), ('couch', 77), ('bowl', 71), ('tennis racket', 65), ('cell phone', 63), ('remote', 56), ('potted plant', 55), ('tie', 55), ('backpack', 51), ('laptop', 50), ('car', 45), ('knife', 44), ('oven', 44), ('sports ball', 42), ('refrigerator', 40), ('sink', 38), ('vase', 36), ('spoon', 35), ('bench', 35), ('wine glass', 33), ('microwave', 32), ('bed', 32), ('fork', 31), ('cake', 28), ('dog', 28), ('pizza', 25), ('keyboard', 23), ('umbrella', 21), ('sandwich', 20), ('suitcase', 20), ('bicycle', 19), ('truck', 19), ('traffic light', 17), ('mouse', 17), ('cat', 15), ('motorcycle', 12), ('surfboard', 11), ('orange', 11), ('banana', 11), ('teddy bear', 11), ('bus', 10), ('donut', 10), ('horse', 10), ('apple', 9), ('scissors', 9), ('bird', 9), ('train', 9), ('frisbee', 8), ('skateboard', 8), ('hot dog', 8), ('boat', 7), ('carrot', 7), ('toothbrush', 5), ('hair drier', 5), ('baseball bat', 5), ('kite', 4), ('toilet', 4), ('stop sign', 4), ('toaster', 3), ('baseball glove', 3), ('broccoli', 3), ('skis', 2), ('elephant', 2), ('parking meter', 2), ('fire hydrant', 2), ('airplane', 2), ('cow', 2), ('giraffe', 1), ('snowboard', 1)]",267
suitcase,731,450,281,"[('handbag', 277), ('backpack', 221), ('car', 122), ('chair', 86), ('bench', 63), ('tie', 59), ('cell phone', 58), ('truck', 53), ('bicycle', 51), ('train', 39), ('umbrella', 38), ('bottle', 37), ('book', 36), ('bus', 35), ('tv', 34), ('traffic light', 30), ('dog', 29), ('bed', 27), ('laptop', 25), ('cup', 23), ('airplane', 23), ('potted plant', 22), ('dining table', 21), ('clock', 20), ('couch', 20), ('motorcycle', 18), ('skateboard', 13), ('sink', 9), ('boat', 9), ('stop sign', 8), ('microwave', 7), ('sports ball', 7), ('tennis racket', 7), ('bowl', 7), ('teddy bear', 6), ('remote', 6), ('fire hydrant', 6), ('oven', 5), ('parking meter', 5), ('horse', 5), ('refrigerator', 4), ('vase', 4), ('mouse', 4), ('cat', 4), ('banana', 3), ('bird', 3), ('spoon', 2), ('knife', 2), ('frisbee', 2), ('cow', 2), ('kite', 2), ('baseball bat', 2), ('cake', 2), ('sheep', 2), ('carrot', 2), ('apple', 2), ('orange', 1), ('pizza', 1), ('hair drier', 1), ('toothbrush', 1), ('baseball glove', 1), ('fork', 1), ('skis', 1), ('donut', 1), ('hot dog', 1), ('scissors', 1), ('wine glass', 1), ('elephant', 1), ('keyboard', 1)]",281
pizza,720,413,307,"[('dining table', 388), ('cup', 264), ('chair', 253), ('knife', 224), ('bottle', 199), ('fork', 187), ('bowl', 122), ('oven', 80), ('wine glass', 77), ('spoon', 59), ('potted plant', 44), ('handbag', 43), ('car', 39), ('cell phone', 34), ('refrigerator', 31), ('bench', 29), ('couch', 28), ('tv', 26), ('microwave', 26), ('clock', 25), ('book', 23), ('sandwich', 22), ('sink', 18), ('vase', 14), ('tie', 11), ('laptop', 11), ('broccoli', 10), ('backpack', 10), ('umbrella', 10), ('keyboard', 9), ('dog', 9), ('carrot', 8), ('mouse', 8), ('scissors', 8), ('truck', 8), ('cake', 5), ('remote', 5), ('hot dog', 4), ('cat', 4), ('bed', 4), ('bicycle', 4), ('orange', 3), ('traffic light', 2), ('toaster', 2), ('parking meter', 2), ('frisbee', 2), ('banana', 2), ('apple', 2), ('donut', 2), ('sports ball', 2), ('suitcase', 1), ('surfboard', 1), ('teddy bear', 1), ('skateboard', 1)]",307
traffic light,710,509,201,"[('car', 504), ('handbag', 243), ('truck', 199), ('bicycle', 168), ('backpack', 147), ('bus', 144), ('motorcycle', 100), ('umbrella', 92), ('cell phone', 67), ('skateboard', 63), ('fire hydrant', 48), ('bench', 43), ('tie', 37), ('train', 35), ('horse', 30), ('suitcase', 30), ('parking meter', 25), ('dog', 21), ('chair', 21), ('potted plant', 20), ('stop sign', 18), ('clock', 17), ('cup', 12), ('bottle', 12), ('dining table', 10), ('bird', 7), ('laptop', 6), ('book', 6), ('sports ball', 6), ('tv', 5), ('skis', 5), ('elephant', 5), ('donut', 5), ('sandwich', 4), ('kite', 4), ('hot dog', 4), ('baseball glove', 3), ('surfboard', 3), ('teddy bear', 3), ('frisbee', 3), ('tennis racket', 3), ('orange', 3), ('boat', 2), ('banana', 2), ('vase', 2), ('pizza', 2), ('snowboard', 2), ('bowl', 1), ('keyboard', 1), ('airplane', 1), ('oven', 1), ('carrot', 1), ('cake', 1), ('scissors', 1), ('toothbrush', 1), ('baseball bat', 1), ('apple', 1)]",201
bed,708,327,381,"[('book', 158), ('laptop', 119), ('chair', 96), ('bottle', 66), ('cell phone', 63), ('dog', 62), ('cat', 61), ('couch', 54), ('remote', 53), ('teddy bear', 50), ('cup', 50), ('tv', 46), ('clock', 32), ('handbag', 27), ('suitcase', 27), ('potted plant', 26), ('backpack', 25), ('tie', 20), ('bowl', 17), ('dining table', 15), ('keyboard', 14), ('vase', 12), ('toothbrush', 11), ('sink', 9), ('mouse', 7), ('spoon', 7), ('oven', 7), ('wine glass', 7), ('fork', 6), ('bird', 6), ('microwave', 6), ('knife', 5), ('surfboard', 5), ('refrigerator', 4), ('scissors', 4), ('umbrella', 4), ('sandwich', 4), ('cake', 4), ('pizza', 4), ('bicycle', 4), ('toilet', 3), ('donut', 3), ('orange', 3), ('hair drier', 3), ('carrot', 3), ('banana', 3), ('car', 3), ('sports ball', 2), ('snowboard', 2), ('apple', 2), ('skateboard', 1), ('hot dog', 1), ('fire hydrant', 1), ('horse', 1), ('elephant', 1), ('truck', 1), ('bench', 1), ('broccoli', 1), ('stop sign', 1), ('skis', 1), ('cow', 1)]",327
cake,685,306,379,"[('dining table', 443), ('knife', 284), ('chair', 282), ('cup', 256), ('bowl', 157), ('fork', 156), ('bottle', 145), ('spoon', 142), ('wine glass', 76), ('tie', 55), ('cell phone', 46), ('handbag', 45), ('couch', 44), ('potted plant', 43), ('book', 38), ('oven', 38), ('tv', 38), ('vase', 36), ('refrigerator', 33), ('donut', 30), ('clock', 28), ('microwave', 23), ('sandwich', 21), ('dog', 18), ('car', 18), ('sink', 16), ('backpack', 14), ('orange', 14), ('banana', 13), ('bench', 11), ('remote', 10), ('scissors', 9), ('laptop', 8), ('keyboard', 7), ('apple', 7), ('hot dog', 6), ('umbrella', 6), ('bicycle', 5), ('cat', 5), ('pizza', 5), ('truck', 5), ('carrot', 5), ('toaster', 5), ('mouse', 5), ('teddy bear', 5), ('bed', 4), ('bird', 3), ('broccoli', 2), ('stop sign', 2), ('suitcase', 2), ('frisbee', 2), ('boat', 2), ('horse', 2), ('skateboard', 1), ('sports ball', 1), ('traffic light', 1)]",306
bus,671,474,197,"[('car', 337), ('handbag', 187), ('truck', 150), ('traffic light', 144), ('backpack', 130), ('bicycle', 125), ('motorcycle', 82), ('umbrella', 61), ('cell phone', 52), ('horse', 38), ('bench', 36), ('skateboard', 35), ('suitcase', 35), ('tie', 29), ('chair', 24), ('fire hydrant', 18), ('train', 17), ('dog', 16), ('stop sign', 15), ('bottle', 14), ('potted plant', 13), ('cow', 11), ('clock', 10), ('parking meter', 10), ('bird', 9), ('kite', 9), ('dining table', 7), ('tennis racket', 7), ('cup', 7), ('book', 6), ('airplane', 6), ('sports ball', 6), ('elephant', 6), ('sandwich', 5), ('donut', 4), ('surfboard', 4), ('sheep', 4), ('boat', 4), ('skis', 4), ('banana', 4), ('baseball glove', 3), ('hot dog', 3), ('orange', 3), ('frisbee', 3), ('laptop', 3), ('baseball bat', 3), ('tv', 2), ('apple', 2), ('teddy bear', 2), ('bear', 1), ('carrot', 1), ('giraffe', 1), ('snowboard', 1), ('zebra', 1), ('knife', 1), ('bowl', 1), ('hair drier', 1)]",197
fork,663,299,364,"[('dining table', 535), ('cup', 407), ('knife', 393), ('chair', 351), ('bowl', 232), ('bottle', 222), ('spoon', 212), ('pizza', 187), ('wine glass', 177), ('cake', 156), ('sandwich', 77), ('potted plant', 69), ('cell phone', 54), ('handbag', 48), ('couch', 46), ('carrot', 35), ('book', 33), ('clock', 31), ('tv', 30), ('vase', 30), ('bench', 28), ('broccoli', 27), ('tie', 27), ('car', 26), ('oven', 25), ('orange', 20), ('umbrella', 20), ('donut', 18), ('sink', 17), ('banana', 16), ('microwave', 15), ('laptop', 14), ('hot dog', 13), ('refrigerator', 13), ('apple', 13), ('backpack', 9), ('keyboard', 8), ('remote', 8), ('dog', 8), ('cat', 7), ('bed', 6), ('mouse', 6), ('bicycle', 5), ('boat', 4), ('scissors', 3), ('truck', 3), ('toaster', 2), ('bird', 2), ('toothbrush', 1), ('teddy bear', 1), ('parking meter', 1), ('suitcase', 1), ('bear', 1), ('stop sign', 1)]",299
oven,660,361,299,"[('bowl', 296), ('bottle', 281), ('cup', 205), ('sink', 202), ('refrigerator', 196), ('spoon', 179), ('microwave', 176), ('knife', 158), ('dining table', 129), ('chair', 113), ('pizza', 80), ('potted plant', 58), ('book', 51), ('clock', 44), ('wine glass', 43), ('cake', 38), ('vase', 34), ('fork', 25), ('handbag', 25), ('dog', 24), ('cell phone', 24), ('tv', 23), ('orange', 23), ('banana', 23), ('apple', 21), ('couch', 19), ('laptop', 18), ('sandwich', 18), ('carrot', 18), ('toaster', 15), ('remote', 15), ('donut', 12), ('scissors', 11), ('broccoli', 10), ('backpack', 10), ('bird', 9), ('bed', 7), ('hot dog', 7), ('tie', 7), ('cat', 6), ('suitcase', 5), ('keyboard', 5), ('car', 4), ('toothbrush', 2), ('bench', 2), ('horse', 2), ('bicycle', 1), ('traffic light', 1), ('hair drier', 1), ('umbrella', 1)]",299
boat,653,518,135,"[('surfboard', 97), ('umbrella', 56), ('dog', 50), ('bench', 49), ('handbag', 45), ('chair', 44), ('backpack', 42), ('kite', 37), ('car', 34), ('bicycle', 29), ('bird', 29), ('frisbee', 28), ('bottle', 25), ('cell phone', 20), ('skateboard', 19), ('dining table', 17), ('truck', 14), ('cup', 12), ('skis', 11), ('sports ball', 11), ('suitcase', 9), ('potted plant', 9), ('apple', 9), ('banana', 9), ('knife', 8), ('horse', 8), ('bowl', 8), ('clock', 7), ('tie', 7), ('tv', 6), ('sandwich', 6), ('wine glass', 6), ('snowboard', 5), ('cow', 4), ('motorcycle', 4), ('fork', 4), ('airplane', 4), ('bus', 4), ('hot dog', 4), ('laptop', 4), ('train', 3), ('orange', 3), ('teddy bear', 3), ('elephant', 3), ('book', 3), ('traffic light', 2), ('cat', 2), ('couch', 2), ('cake', 2), ('donut', 2), ('baseball glove', 2), ('vase', 2), ('fire hydrant', 2), ('remote', 1), ('baseball bat', 1), ('sheep', 1), ('spoon', 1), ('parking meter', 1), ('keyboard', 1), ('tennis racket', 1)]",135
sink,614,316,298,"[('bottle', 285), ('bowl', 227), ('oven', 202), ('cup', 201), ('refrigerator', 133), ('knife', 125), ('microwave', 113), ('spoon', 108), ('toilet', 98), ('chair', 92), ('dining table', 92), ('toothbrush', 58), ('potted plant', 58), ('vase', 54), ('cell phone', 50), ('wine glass', 43), ('handbag', 41), ('book', 39), ('clock', 38), ('laptop', 24), ('dog', 23), ('tv', 20), ('orange', 19), ('pizza', 18), ('banana', 18), ('fork', 17), ('hair drier', 16), ('cake', 16), ('scissors', 15), ('apple', 15), ('tie', 13), ('sandwich', 13), ('couch', 12), ('remote', 11), ('toaster', 11), ('backpack', 11), ('broccoli', 11), ('carrot', 10), ('suitcase', 9), ('donut', 9), ('cat', 9), ('bed', 9), ('hot dog', 4), ('keyboard', 3), ('bird', 3), ('car', 2), ('teddy bear', 2), ('mouse', 1), ('bench', 1), ('bicycle', 1), ('horse', 1), ('skateboard', 1), ('cow', 1)]",298
refrigerator,529,288,241,"[('bottle', 246), ('oven', 196), ('bowl', 191), ('cup', 158), ('chair', 141), ('sink', 133), ('dining table', 125), ('microwave', 122), ('knife', 89), ('spoon', 80), ('potted plant', 50), ('book', 49), ('clock', 40), ('tv', 37), ('couch', 37), ('cell phone', 37), ('cake', 33), ('wine glass', 31), ('pizza', 31), ('laptop', 30), ('vase', 30), ('handbag', 29), ('orange', 26), ('apple', 22), ('dog', 21), ('remote', 21), ('banana', 18), ('backpack', 15), ('donut', 13), ('tie', 13), ('fork', 13), ('cat', 13), ('sandwich', 12), ('keyboard', 8), ('scissors', 8), ('toaster', 8), ('carrot', 8), ('car', 7), ('mouse', 6), ('hot dog', 6), ('bicycle', 5), ('suitcase', 4), ('bed', 4), ('teddy bear', 4), ('umbrella', 4), ('bird', 4), ('broccoli', 3), ('toothbrush', 3), ('truck', 3), ('motorcycle', 2), ('bear', 2), ('kite', 2), ('skateboard', 2), ('bench', 2), ('sheep', 1), ('stop sign', 1), ('horse', 1), ('tennis racket', 1)]",241
banana,490,285,205,"[('bowl', 80), ('apple', 75), ('chair', 72), ('orange', 69), ('bottle', 64), ('dining table', 52), ('handbag', 50), ('cup', 48), ('bicycle', 39), ('car', 36), ('knife', 36), ('umbrella', 32), ('motorcycle', 29), ('spoon', 28), ('backpack', 26), ('truck', 24), ('oven', 23), ('refrigerator', 18), ('potted plant', 18), ('sink', 18), ('fork', 16), ('book', 15), ('cake', 13), ('microwave', 12), ('tie', 12), ('clock', 11), ('bench', 11), ('vase', 10), ('laptop', 9), ('boat', 9), ('tv', 9), ('wine glass', 9), ('keyboard', 7), ('couch', 7), ('sandwich', 7), ('dog', 7), ('cell phone', 6), ('carrot', 5), ('broccoli', 4), ('bus', 4), ('elephant', 3), ('remote', 3), ('horse', 3), ('donut', 3), ('scissors', 3), ('bed', 3), ('suitcase', 3), ('traffic light', 2), ('cow', 2), ('pizza', 2), ('cat', 2), ('toaster', 2), ('kite', 1), ('mouse', 1), ('parking meter', 1), ('skis', 1), ('bird', 1), ('frisbee', 1), ('train', 1), ('sheep', 1), ('tennis racket', 1), ('surfboard', 1)]",205
vase,423,194,229,"[('chair', 179), ('cup', 164), ('dining table', 155), ('potted plant', 152), ('bottle', 134), ('bowl', 100), ('couch', 97), ('book', 95), ('remote', 63), ('tv', 60), ('wine glass', 56), ('knife', 54), ('sink', 54), ('spoon', 38), ('cake', 36), ('clock', 36), ('handbag', 36), ('cell phone', 36), ('laptop', 34), ('oven', 34), ('tie', 32), ('fork', 30), ('refrigerator', 30), ('microwave', 24), ('dog', 19), ('backpack', 19), ('pizza', 14), ('bed', 12), ('sandwich', 10), ('banana', 10), ('apple', 10), ('cat', 9), ('teddy bear', 9), ('umbrella', 9), ('scissors', 7), ('orange', 6), ('toilet', 6), ('toothbrush', 6), ('car', 5), ('keyboard', 5), ('carrot', 5), ('mouse', 4), ('bench', 4), ('suitcase', 4), ('bird', 4), ('hair drier', 3), ('broccoli', 2), ('traffic light', 2), ('donut', 2), ('boat', 2), ('tennis racket', 1), ('truck', 1), ('stop sign', 1), ('toaster', 1), ('bear', 1), ('horse', 1), ('bicycle', 1), ('elephant', 1), ('kite', 1), ('surfboard', 1), ('hot dog', 1), ('cow', 1)]",194
donut,410,245,165,"[('dining table', 106), ('cup', 104), ('chair', 70), ('bottle', 50), ('handbag', 39), ('bowl', 38), ('car', 34), ('cake', 30), ('spoon', 28), ('knife', 24), ('sandwich', 22), ('book', 19), ('fork', 18), ('cell phone', 17), ('couch', 16), ('refrigerator', 13), ('tv', 13), ('keyboard', 12), ('oven', 12), ('clock', 10), ('bench', 10), ('potted plant', 10), ('sink', 9), ('wine glass', 8), ('backpack', 8), ('umbrella', 7), ('tie', 6), ('laptop', 6), ('truck', 6), ('bicycle', 5), ('mouse', 5), ('dog', 5), ('traffic light', 5), ('bus', 4), ('microwave', 4), ('bed', 3), ('orange', 3), ('cat', 3), ('banana', 3), ('motorcycle', 2), ('teddy bear', 2), ('remote', 2), ('pizza', 2), ('bird', 2), ('vase', 2), ('hot dog', 2), ('boat', 2), ('carrot', 2), ('surfboard', 1), ('suitcase', 1), ('baseball bat', 1), ('parking meter', 1), ('hair drier', 1), ('sports ball', 1), ('toaster', 1)]",165
sandwich,409,236,173,"[('dining table', 197), ('cup', 158), ('chair', 126), ('bottle', 106), ('bowl', 99), ('knife', 89), ('hot dog', 78), ('fork', 77), ('spoon', 69), ('wine glass', 47), ('handbag', 32), ('potted plant', 29), ('bench', 25), ('car', 24), ('cell phone', 24), ('donut', 22), ('pizza', 22), ('cake', 21), ('clock', 20), ('oven', 18), ('carrot', 16), ('umbrella', 14), ('book', 14), ('tv', 13), ('sink', 13), ('couch', 12), ('refrigerator', 12), ('microwave', 11), ('bicycle', 11), ('backpack', 11), ('vase', 10), ('broccoli', 9), ('laptop', 8), ('tie', 8), ('banana', 7), ('boat', 6), ('bus', 5), ('orange', 5), ('keyboard', 5), ('remote', 5), ('apple', 5), ('traffic light', 4), ('bed', 4), ('truck', 4), ('mouse', 4), ('dog', 3), ('stop sign', 3), ('motorcycle', 2), ('train', 2), ('teddy bear', 2), ('toaster', 2), ('cat', 2), ('skateboard', 2), ('fire hydrant', 1), ('frisbee', 1)]",173
elephant,392,312,80,"[('handbag', 43), ('bench', 39), ('car', 36), ('motorcycle', 19), ('backpack', 18), ('umbrella', 18), ('chair', 18), ('truck', 17), ('bicycle', 14), ('bottle', 8), ('sports ball', 7), ('cell phone', 6), ('bus', 6), ('potted plant', 6), ('bowl', 5), ('traffic light', 5), ('dining table', 4), ('bird', 4), ('banana', 3), ('dog', 3), ('boat', 3), ('book', 2), ('tie', 2), ('train', 2), ('clock', 2), ('stop sign', 2), ('horse', 2), ('cup', 2), ('cow', 1), ('carrot', 1), ('orange', 1), ('bed', 1), ('toilet', 1), ('vase', 1), ('suitcase', 1)]",80
train,364,266,98,"[('handbag', 95), ('backpack', 68), ('car', 41), ('suitcase', 39), ('bench', 38), ('bicycle', 36), ('traffic light', 35), ('cell phone', 32), ('tie', 26), ('bus', 17), ('umbrella', 16), ('chair', 15), ('truck', 14), ('bottle', 13), ('skateboard', 9), ('book', 9), ('clock', 9), ('potted plant', 5), ('stop sign', 5), ('motorcycle', 4), ('boat', 3), ('tv', 3), ('horse', 3), ('cup', 3), ('couch', 3), ('cow', 2), ('elephant', 2), ('bird', 2), ('sandwich', 2), ('apple', 2), ('kite', 2), ('laptop', 2), ('parking meter', 1), ('surfboard', 1), ('orange', 1), ('teddy bear', 1), ('hot dog', 1), ('wine glass', 1), ('banana', 1), ('bowl', 1), ('dining table', 1)]",98
hot dog,355,224,131,"[('dining table', 96), ('chair', 79), ('sandwich', 78), ('cup', 74), ('bottle', 72), ('handbag', 44), ('bowl', 28), ('car', 25), ('bench', 20), ('umbrella', 19), ('backpack', 18), ('knife', 18), ('spoon', 15), ('fork', 13), ('potted plant', 12), ('couch', 9), ('tv', 8), ('truck', 8), ('clock', 8), ('oven', 7), ('cake', 6), ('refrigerator', 6), ('tie', 6), ('dog', 6), ('carrot', 6), ('wine glass', 5), ('book', 5), ('bicycle', 5), ('pizza', 4), ('sink', 4), ('cell phone', 4), ('boat', 4), ('traffic light', 4), ('broccoli', 3), ('bus', 3), ('orange', 3), ('microwave', 2), ('keyboard', 2), ('parking meter', 2), ('apple', 2), ('donut', 2), ('skateboard', 2), ('bird', 2), ('remote', 1), ('bed', 1), ('scissors', 1), ('suitcase', 1), ('train', 1), ('tennis racket', 1), ('laptop', 1), ('vase', 1)]",131
teddy bear,349,136,213,"[('chair', 78), ('couch', 51), ('bed', 50), ('handbag', 39), ('book', 37), ('bottle', 31), ('dining table', 30), ('cup', 28), ('backpack', 23), ('tv', 20), ('potted plant', 20), ('cell phone', 19), ('remote', 18), ('car', 18), ('laptop', 14), ('tie', 13), ('bench', 12), ('dog', 12), ('clock', 11), ('bowl', 11), ('vase', 9), ('umbrella', 7), ('keyboard', 7), ('bicycle', 7), ('wine glass', 7), ('suitcase', 6), ('mouse', 6), ('cat', 5), ('motorcycle', 5), ('cake', 5), ('scissors', 4), ('refrigerator', 4), ('toothbrush', 4), ('boat', 3), ('traffic light', 3), ('knife', 3), ('toilet', 3), ('donut', 2), ('sandwich', 2), ('truck', 2), ('orange', 2), ('microwave', 2), ('giraffe', 2), ('hair drier', 2), ('bird', 2), ('horse', 2), ('spoon', 2), ('sink', 2), ('skis', 2), ('bus', 2), ('bear', 2), ('fork', 1), ('airplane', 1), ('fire hydrant', 1), ('sports ball', 1), ('train', 1), ('snowboard', 1), ('cow', 1), ('pizza', 1), ('tennis racket', 1), ('kite', 1), ('surfboard', 1), ('apple', 1)]",136
cat,339,168,171,"[('couch', 76), ('chair', 65), ('bed', 61), ('laptop', 51), ('book', 51), ('cup', 45), ('remote', 34), ('bottle', 33), ('potted plant', 30), ('dining table', 27), ('tv', 25), ('cell phone', 24), ('dog', 23), ('bowl', 20), ('handbag', 19), ('bench', 15), ('clock', 15), ('keyboard', 14), ('refrigerator', 13), ('mouse', 11), ('backpack', 10), ('vase', 9), ('sink', 9), ('wine glass', 8), ('tie', 7), ('spoon', 7), ('fork', 7), ('oven', 6), ('knife', 5), ('cake', 5), ('teddy bear', 5), ('umbrella', 5), ('car', 5), ('bicycle', 5), ('pizza', 4), ('microwave', 4), ('suitcase', 4), ('bird', 3), ('apple', 3), ('donut', 3), ('scissors', 3), ('motorcycle', 3), ('boat', 2), ('stop sign', 2), ('surfboard', 2), ('sandwich', 2), ('toilet', 2), ('banana', 2), ('cow', 1), ('airplane', 1), ('parking meter', 1), ('baseball bat', 1), ('carrot', 1), ('horse', 1), ('orange', 1), ('truck', 1), ('tennis racket', 1), ('skis', 1), ('fire hydrant', 1), ('toaster', 1)]",168
keyboard,322,221,101,"[('tv', 167), ('laptop', 165), ('chair', 143), ('mouse', 131), ('book', 91), ('cup', 85), ('cell phone', 67), ('remote', 49), ('couch', 42), ('bottle', 41), ('dining table', 39), ('potted plant', 32), ('clock', 23), ('handbag', 20), ('bowl', 18), ('backpack', 17), ('cat', 14), ('bed', 14), ('tie', 13), ('donut', 12), ('wine glass', 12), ('dog', 10), ('pizza', 9), ('refrigerator', 8), ('fork', 8), ('banana', 7), ('scissors', 7), ('cake', 7), ('teddy bear', 7), ('spoon', 7), ('car', 6), ('vase', 5), ('sandwich', 5), ('oven', 5), ('knife', 4), ('microwave', 4), ('apple', 4), ('sink', 3), ('carrot', 2), ('toothbrush', 2), ('hot dog', 2), ('truck', 2), ('bench', 2), ('toilet', 2), ('bird', 1), ('sheep', 1), ('traffic light', 1), ('sports ball', 1), ('stop sign', 1), ('bicycle', 1), ('snowboard', 1), ('broccoli', 1), ('parking meter', 1), ('boat', 1), ('toaster', 1), ('skateboard', 1), ('suitcase', 1), ('kite', 1)]",101
microwave,316,163,153,"[('oven', 176), ('bottle', 153), ('bowl', 149), ('cup', 128), ('refrigerator', 122), ('sink', 113), ('chair', 82), ('knife', 74), ('dining table', 72), ('spoon', 55), ('potted plant', 41), ('book', 35), ('clock', 32), ('pizza', 26), ('vase', 24), ('cake', 23), ('wine glass', 20), ('tv', 19), ('handbag', 18), ('cell phone', 18), ('remote', 16), ('couch', 16), ('orange', 15), ('fork', 15), ('apple', 13), ('laptop', 12), ('banana', 12), ('toaster', 12), ('dog', 11), ('sandwich', 11), ('scissors', 9), ('suitcase', 7), ('broccoli', 7), ('bed', 6), ('carrot', 5), ('backpack', 5), ('toothbrush', 4), ('cat', 4), ('keyboard', 4), ('donut', 4), ('car', 3), ('tie', 3), ('hot dog', 2), ('teddy bear', 2), ('truck', 2), ('bird', 2), ('bicycle', 1), ('sports ball', 1), ('hair drier', 1), ('umbrella', 1), ('bench', 1), ('mouse', 1)]",153
bird,314,217,97,"[('handbag', 44), ('bench', 43), ('surfboard', 32), ('car', 31), ('chair', 29), ('boat', 29), ('backpack', 25), ('cup', 21), ('bicycle', 20), ('dog', 17), ('skateboard', 16), ('umbrella', 16), ('cell phone', 14), ('bottle', 13), ('dining table', 11), ('kite', 11), ('truck', 11), ('frisbee', 9), ('bus', 9), ('clock', 9), ('bowl', 9), ('oven', 9), ('potted plant', 8), ('cow', 8), ('motorcycle', 8), ('couch', 7), ('book', 7), ('traffic light', 7), ('horse', 7), ('bed', 6), ('tie', 6), ('giraffe', 6), ('tv', 4), ('elephant', 4), ('knife', 4), ('spoon', 4), ('vase', 4), ('refrigerator', 4), ('cat', 3), ('orange', 3), ('cake', 3), ('laptop', 3), ('apple', 3), ('suitcase', 3), ('sink', 3), ('remote', 2), ('airplane', 2), ('train', 2), ('toothbrush', 2), ('fork', 2), ('teddy bear', 2), ('donut', 2), ('wine glass', 2), ('zebra', 2), ('hot dog', 2), ('microwave', 2), ('keyboard', 1), ('mouse', 1), ('broccoli', 1), ('fire hydrant', 1), ('baseball glove', 1), ('bear', 1), ('banana', 1), ('toaster', 1), ('scissors', 1), ('baseball bat', 1)]",97
toothbrush,299,167,132,"[('sink', 58), ('bottle', 42), ('cup', 27), ('toilet', 26), ('cell phone', 20), ('book', 18), ('chair', 16), ('couch', 15), ('bed', 11), ('tv', 10), ('bowl', 9), ('potted plant', 8), ('handbag', 8), ('dining table', 7), ('vase', 6), ('hair drier', 6), ('clock', 5), ('car', 5), ('dog', 5), ('microwave', 4), ('bench', 4), ('teddy bear', 4), ('refrigerator', 3), ('laptop', 3), ('bicycle', 3), ('remote', 3), ('tie', 3), ('backpack', 3), ('knife', 2), ('oven', 2), ('keyboard', 2), ('sports ball', 2), ('bird', 2), ('scissors', 2), ('umbrella', 2), ('spoon', 2), ('fork', 1), ('suitcase', 1), ('wine glass', 1), ('traffic light', 1), ('truck', 1), ('skis', 1)]",132
cow,299,230,69,"[('horse', 50), ('car', 40), ('truck', 30), ('motorcycle', 25), ('handbag', 20), ('dog', 19), ('bicycle', 17), ('backpack', 12), ('umbrella', 12), ('tie', 11), ('bus', 11), ('chair', 10), ('sheep', 9), ('bird', 8), ('bench', 8), ('cell phone', 7), ('bottle', 6), ('dining table', 6), ('boat', 4), ('cup', 4), ('tv', 4), ('laptop', 3), ('potted plant', 3), ('train', 2), ('suitcase', 2), ('banana', 2), ('stop sign', 2), ('clock', 2), ('cat', 1), ('elephant', 1), ('knife', 1), ('bowl', 1), ('teddy bear', 1), ('frisbee', 1), ('bed', 1), ('toilet', 1), ('sink', 1), ('hair drier', 1), ('vase', 1)]",69
fire hydrant,262,180,82,"[('car', 133), ('handbag', 67), ('truck', 56), ('backpack', 50), ('traffic light', 48), ('umbrella', 30), ('bicycle', 30), ('cell phone', 24), ('skateboard', 20), ('bus', 18), ('stop sign', 16), ('bench', 13), ('chair', 12), ('potted plant', 12), ('parking meter', 11), ('motorcycle', 10), ('cup', 9), ('dog', 6), ('suitcase', 6), ('horse', 6), ('bottle', 5), ('book', 4), ('dining table', 3), ('wine glass', 3), ('baseball bat', 3), ('tie', 2), ('sports ball', 2), ('clock', 2), ('surfboard', 2), ('frisbee', 2), ('boat', 2), ('sandwich', 1), ('snowboard', 1), ('teddy bear', 1), ('bed', 1), ('orange', 1), ('apple', 1), ('baseball glove', 1), ('bird', 1), ('kite', 1), ('tv', 1), ('cat', 1), ('tennis racket', 1)]",82
mouse,243,167,76,"[('laptop', 153), ('chair', 138), ('keyboard', 131), ('tv', 113), ('book', 89), ('cup', 69), ('cell phone', 60), ('bottle', 36), ('dining table', 34), ('remote', 30), ('couch', 29), ('potted plant', 29), ('clock', 17), ('backpack', 14), ('handbag', 14), ('cat', 11), ('bowl', 9), ('pizza', 8), ('dog', 7), ('bed', 7), ('wine glass', 7), ('refrigerator', 6), ('scissors', 6), ('tie', 6), ('fork', 6), ('teddy bear', 6), ('donut', 5), ('cake', 5), ('vase', 4), ('suitcase', 4), ('knife', 4), ('sandwich', 4), ('bicycle', 2), ('sports ball', 2), ('umbrella', 2), ('car', 2), ('apple', 2), ('toilet', 2), ('bird', 1), ('sink', 1), ('sheep', 1), ('bench', 1), ('banana', 1), ('carrot', 1), ('broccoli', 1), ('microwave', 1), ('motorcycle', 1)]",76
scissors,236,129,107,"[('chair', 48), ('bottle', 38), ('cup', 38), ('dining table', 31), ('bowl', 27), ('knife', 25), ('book', 21), ('sink', 15), ('laptop', 14), ('tie', 12), ('handbag', 11), ('oven', 11), ('spoon', 11), ('tv', 10), ('cake', 9), ('microwave', 9), ('clock', 9), ('cell phone', 9), ('couch', 9), ('refrigerator', 8), ('pizza', 8), ('potted plant', 8), ('keyboard', 7), ('backpack', 7), ('wine glass', 7), ('vase', 7), ('mouse', 6), ('sheep', 6), ('car', 6), ('carrot', 5), ('bed', 4), ('teddy bear', 4), ('dog', 4), ('bench', 4), ('umbrella', 4), ('bicycle', 3), ('cat', 3), ('remote', 3), ('fork', 3), ('banana', 3), ('toaster', 2), ('truck', 2), ('toothbrush', 2), ('apple', 2), ('orange', 2), ('toilet', 1), ('hot dog', 1), ('suitcase', 1), ('kite', 1), ('stop sign', 1), ('motorcycle', 1), ('traffic light', 1), ('hair drier', 1), ('bird', 1)]",107
stop sign,234,170,64,"[('car', 132), ('truck', 49), ('handbag', 49), ('bicycle', 47), ('backpack', 37), ('motorcycle', 23), ('traffic light', 18), ('skateboard', 18), ('fire hydrant', 16), ('bus', 15), ('cell phone', 14), ('umbrella', 14), ('chair', 12), ('bench', 11), ('horse', 8), ('dog', 8), ('suitcase', 8), ('bottle', 7), ('potted plant', 6), ('cup', 6), ('train', 5), ('skis', 5), ('parking meter', 4), ('clock', 4), ('tie', 4), ('knife', 3), ('sandwich', 3), ('book', 2), ('kite', 2), ('cat', 2), ('elephant', 2), ('dining table', 2), ('cake', 2), ('sports ball', 2), ('tennis racket', 2), ('cow', 2), ('bowl', 2), ('snowboard', 2), ('couch', 1), ('keyboard', 1), ('airplane', 1), ('carrot', 1), ('refrigerator', 1), ('vase', 1), ('surfboard', 1), ('scissors', 1), ('wine glass', 1), ('fork', 1), ('spoon', 1), ('frisbee', 1), ('bed', 1), ('sheep', 1)]",64
toilet,226,153,73,"[('sink', 98), ('bottle', 42), ('toothbrush', 26), ('cell phone', 17), ('cup', 13), ('book', 11), ('backpack', 8), ('bowl', 8), ('handbag', 7), ('tie', 7), ('vase', 6), ('car', 5), ('dog', 5), ('hair drier', 5), ('clock', 4), ('potted plant', 4), ('chair', 4), ('bed', 3), ('laptop', 3), ('tv', 3), ('teddy bear', 3), ('cat', 2), ('keyboard', 2), ('mouse', 2), ('truck', 1), ('scissors', 1), ('elephant', 1), ('dining table', 1), ('wine glass', 1), ('remote', 1), ('cow', 1)]",73
apple,219,117,102,"[('orange', 81), ('banana', 75), ('bowl', 55), ('dining table', 54), ('bottle', 52), ('chair', 50), ('knife', 43), ('cup', 39), ('handbag', 30), ('refrigerator', 22), ('spoon', 21), ('oven', 21), ('potted plant', 15), ('sink', 15), ('car', 13), ('microwave', 13), ('fork', 13), ('wine glass', 13), ('backpack', 12), ('umbrella', 11), ('bicycle', 11), ('laptop', 10), ('vase', 10), ('tv', 10), ('book', 10), ('clock', 9), ('cell phone', 9), ('couch', 9), ('boat', 9), ('truck', 8), ('motorcycle', 8), ('broccoli', 8), ('cake', 7), ('bench', 7), ('dog', 6), ('carrot', 6), ('tie', 6), ('sandwich', 5), ('keyboard', 4), ('cat', 3), ('bird', 3), ('kite', 2), ('train', 2), ('pizza', 2), ('hot dog', 2), ('bus', 2), ('mouse', 2), ('bed', 2), ('suitcase', 2), ('scissors', 2), ('horse', 1), ('fire hydrant', 1), ('sports ball', 1), ('baseball bat', 1), ('baseball glove', 1), ('toaster', 1), ('traffic light', 1), ('teddy bear', 1)]",102
orange,214,110,104,"[('apple', 81), ('bowl', 69), ('banana', 69), ('dining table', 55), ('bottle', 53), ('cup', 46), ('chair', 45), ('handbag', 34), ('knife', 32), ('refrigerator', 26), ('oven', 23), ('spoon', 22), ('fork', 20), ('potted plant', 20), ('sink', 19), ('car', 17), ('microwave', 15), ('wine glass', 15), ('umbrella', 15), ('cake', 14), ('dog', 13), ('clock', 11), ('truck', 10), ('cell phone', 9), ('backpack', 8), ('bicycle', 8), ('couch', 7), ('tv', 6), ('laptop', 6), ('vase', 6), ('book', 6), ('broccoli', 6), ('carrot', 6), ('sandwich', 5), ('bench', 5), ('motorcycle', 4), ('bed', 3), ('donut', 3), ('boat', 3), ('pizza', 3), ('remote', 3), ('bird', 3), ('hot dog', 3), ('bus', 3), ('traffic light', 3), ('teddy bear', 2), ('scissors', 2), ('toaster', 2), ('tie', 2), ('suitcase', 1), ('skis', 1), ('train', 1), ('fire hydrant', 1), ('elephant', 1), ('giraffe', 1), ('horse', 1), ('cat', 1)]",104
giraffe,181,83,98,"[('handbag', 34), ('backpack', 16), ('bench', 8), ('cell phone', 7), ('bird', 6), ('carrot', 5), ('bottle', 4), ('bowl', 4), ('cup', 3), ('car', 3), ('chair', 3), ('zebra', 3), ('teddy bear', 2), ('sports ball', 1), ('clock', 1), ('potted plant', 1), ('bus', 1), ('orange', 1), ('dining table', 1), ('truck', 1), ('book', 1), ('umbrella', 1)]",83
sheep,180,134,46,"[('dog', 36), ('handbag', 18), ('horse', 18), ('truck', 17), ('car', 15), ('backpack', 13), ('chair', 9), ('cell phone', 9), ('cow', 9), ('bench', 8), ('bottle', 7), ('tie', 6), ('scissors', 6), ('cup', 5), ('bicycle', 5), ('bus', 4), ('motorcycle', 4), ('umbrella', 3), ('knife', 2), ('laptop', 2), ('bowl', 2), ('spoon', 2), ('suitcase', 2), ('mouse', 1), ('keyboard', 1), ('refrigerator', 1), ('book', 1), ('tv', 1), ('potted plant', 1), ('boat', 1), ('dining table', 1), ('banana', 1), ('stop sign', 1)]",46
airplane,180,152,28,"[('truck', 41), ('handbag', 23), ('suitcase', 23), ('car', 19), ('backpack', 14), ('tie', 12), ('bench', 9), ('chair', 7), ('bus', 6), ('motorcycle', 6), ('boat', 4), ('bird', 2), ('cup', 2), ('tennis racket', 2), ('remote', 2), ('bicycle', 2), ('bottle', 2), ('dining table', 2), ('clock', 2), ('skateboard', 2), ('book', 2), ('teddy bear', 1), ('traffic light', 1), ('stop sign', 1), ('umbrella', 1), ('surfboard', 1), ('cat', 1), ('tv', 1), ('hair drier', 1), ('potted plant', 1), ('skis', 1), ('laptop', 1), ('cell phone', 1), ('dog', 1), ('parking meter', 1), ('frisbee', 1), ('kite', 1)]",28
carrot,149,75,74,"[('bowl', 63), ('dining table', 60), ('knife', 54), ('cup', 48), ('bottle', 39), ('spoon', 37), ('chair', 36), ('fork', 35), ('broccoli', 24), ('oven', 18), ('wine glass', 17), ('sandwich', 16), ('handbag', 14), ('car', 13), ('umbrella', 13), ('potted plant', 12), ('sink', 10), ('pizza', 8), ('couch', 8), ('cell phone', 8), ('refrigerator', 8), ('clock', 7), ('backpack', 6), ('apple', 6), ('tie', 6), ('orange', 6), ('book', 6), ('hot dog', 6), ('giraffe', 5), ('cake', 5), ('vase', 5), ('dog', 5), ('scissors', 5), ('banana', 5), ('microwave', 5), ('truck', 5), ('bicycle', 4), ('horse', 4), ('tv', 4), ('laptop', 3), ('bed', 3), ('keyboard', 2), ('motorcycle', 2), ('donut', 2), ('suitcase', 2), ('remote', 2), ('bus', 1), ('traffic light', 1), ('elephant', 1), ('stop sign', 1), ('bear', 1), ('mouse', 1), ('cat', 1), ('bench', 1)]",74
parking meter,128,85,43,"[('car', 88), ('handbag', 41), ('truck', 31), ('traffic light', 25), ('bicycle', 23), ('backpack', 22), ('fire hydrant', 11), ('bench', 11), ('cell phone', 11), ('umbrella', 10), ('bus', 10), ('chair', 8), ('dining table', 7), ('dog', 7), ('skateboard', 6), ('suitcase', 5), ('motorcycle', 5), ('stop sign', 4), ('potted plant', 4), ('tie', 4), ('cup', 3), ('bottle', 3), ('laptop', 3), ('hot dog', 2), ('pizza', 2), ('frisbee', 2), ('clock', 2), ('skis', 2), ('train', 1), ('fork', 1), ('donut', 1), ('keyboard', 1), ('banana', 1), ('boat', 1), ('cat', 1), ('wine glass', 1), ('horse', 1), ('airplane', 1)]",43
broccoli,88,41,47,"[('bowl', 45), ('dining table', 41), ('cup', 34), ('knife', 33), ('fork', 27), ('bottle', 27), ('chair', 25), ('spoon', 25), ('carrot', 24), ('sink', 11), ('pizza', 10), ('wine glass', 10), ('oven', 10), ('handbag', 9), ('sandwich', 9), ('apple', 8), ('microwave', 7), ('orange', 6), ('book', 5), ('tv', 5), ('potted plant', 4), ('umbrella', 4), ('car', 4), ('banana', 4), ('cell phone', 4), ('refrigerator', 3), ('hot dog', 3), ('couch', 3), ('clock', 3), ('vase', 2), ('bench', 2), ('tie', 2), ('bicycle', 2), ('cake', 2), ('backpack', 2), ('bird', 1), ('keyboard', 1), ('motorcycle', 1), ('truck', 1), ('horse', 1), ('bed', 1), ('laptop', 1), ('mouse', 1)]",41
hair drier,72,18,54,"[('sink', 16), ('bottle', 12), ('chair', 11), ('couch', 8), ('handbag', 6), ('cup', 6), ('toothbrush', 6), ('clock', 5), ('dog', 5), ('toilet', 5), ('book', 4), ('bowl', 3), ('cell phone', 3), ('bed', 3), ('vase', 3), ('dining table', 2), ('tv', 2), ('car', 2), ('teddy bear', 2), ('laptop', 1), ('suitcase', 1), ('sports ball', 1), ('airplane', 1), ('scissors', 1), ('microwave', 1), ('oven', 1), ('donut', 1), ('motorcycle', 1), ('bus', 1), ('cow', 1)]",18
bear,37,23,14,"[('chair', 6), ('handbag', 4), ('dining table', 4), ('truck', 3), ('backpack', 3), ('book', 3), ('refrigerator', 2), ('cell phone', 2), ('teddy bear', 2), ('car', 1), ('bus', 1), ('couch', 1), ('wine glass', 1), ('cup', 1), ('fork', 1), ('bowl', 1), ('carrot', 1), ('vase', 1), ('knife', 1), ('bicycle', 1), ('dog', 1), ('bird', 1), ('frisbee', 1), ('bench', 1), ('bottle', 1)]",14
toaster,32,18,14,"[('bottle', 19), ('oven', 15), ('cup', 12), ('microwave', 12), ('spoon', 11), ('sink', 11), ('bowl', 11), ('refrigerator', 8), ('knife', 8), ('cake', 5), ('dining table', 5), ('book', 4), ('chair', 4), ('wine glass', 3), ('clock', 3), ('fork', 2), ('sandwich', 2), ('pizza', 2), ('scissors', 2), ('potted plant', 2), ('laptop', 2), ('banana', 2), ('orange', 2), ('dog', 1), ('handbag', 1), ('cell phone', 1), ('vase', 1), ('keyboard', 1), ('apple', 1), ('bird', 1), ('donut', 1), ('cat', 1), ('tv', 1)]",14
zebra,31,19,12,"[('handbag', 5), ('car', 4), ('tie', 3), ('giraffe', 3), ('horse', 3), ('chair', 2), ('umbrella', 2), ('bird', 2), ('potted plant', 2), ('cup', 1), ('dining table', 1), ('bus', 1), ('bicycle', 1), ('backpack', 1), ('bench', 1)]",12
